------GROUP: DefectiveGroup(false, false, false, true, true, false)
abolir: FormGroup(null, null, null, abolimos, abolis, null)
colorir: FormGroup(null, null, null, colorimos, coloris, null)
demolir: FormGroup(null, null, null, demolimos, demolis, null)
falir: FormGroup(null, null, null, falimos, falis, null)
florir: FormGroup(null, null, null, florimos, floris, null)
remir: FormGroup(null, null, null, remimos, remis, null)
------GROUP: DefectiveGroup(false, false, true, false, false, false)
aprazer: FormGroup(null, null, apraz, null, null, null)
prazer: FormGroup(null, null, praz, null, null, null)
------GROUP: DefectiveGroup(false, true, true, true, true, true)
barrir: FormGroup(null, barres, barre, barrimos, barris, barrem)
delir: FormGroup(null, deles, dele, delimos, delis, delem)
explodir: FormGroup(null, explodes, explode, explodimos, explodis, explodem)
ganir: FormGroup(null, ganes, gane, ganimos, ganis, ganem)
ruir: FormGroup(null, ruis, rui, ruímos, ruís, ruem)
------GROUP: DefectiveGroup(false, false, true, false, false, true)
doer: FormGroup(null, null, dói, null, null, doem)

------GROUP: DefectiveGroup(true, true, true, true, true, true) --- all forms here
aturdir: FormGroup(aturdo, aturdes, aturde, aturdimos, aturdis, aturdem)
banir: FormGroup(bano, banes, bane, banimos, banis, banem)
bramir: FormGroup(bramo, brames, brame, bramimos, bramis, bramem)
brandir: FormGroup(brando, brandes, brande, brandimos, brandis, brandem)
carpir: FormGroup(carpo, carpes, carpe, carpimos, carpis, carpem)
combalir: FormGroup(combalo, combales, combale, combalimos, combalis, combalem)
embair: FormGroup(embaio, embais, embai, embaímos, embaís, embaem)
empedernir: FormGroup(empederno, empedernes, empederne, empedernimos, empedernis, empedernem)
esculpir: FormGroup(esculpo, esculpes, esculpe, esculpimos, esculpis, esculpem)
espavorir: FormGroup(espavoro, espavores, espavore, espavorimos, espavoris, espavorem)
exaurir: FormGroup(exauro, exaures, exaure, exaurimos, exauris, exaurem)
feder: FormGroup(fedo, fedes, fede, fedemos, fedeis, fedem)
garrir: FormGroup(garro, garres, garre, garrimos, garris, garrem)
impingir: FormGroup(impinjo, impinges, impinge, impingimos, impingis, impingem)
jungir: FormGroup(junjo, junges, junge, jungimos, jungis, jungem)
manutenir: FormGroup(manuteno, manutenes, manutene, manutenimos, manutenis, manutenem)
premir: FormGroup(premo, premes, preme, premimos, premis, premem)
renhir: FormGroup(renho, renhes, renhe, renhimos, renhis, renhem)
ressarcir: FormGroup(ressarço, ressarces, ressarce, ressarcimos, ressarcis, ressarcem)
retorquir: FormGroup(retorquo, retorques, retorque, retorquimos, retorquis, retorquem)
soer: FormGroup(soo, sóis, sói, soemos, soeis, soem)
transir: FormGroup(transo, transes, transe, transimos, transis, transem)
