------GROUP: DefectiveGroup(false, false, false, false, true, false)
abolir: FormGroup(null, null, null, null, aboliNormally defective:abulais, null)
colorir: FormGroup(null, null, null, null, coloriNormally defective:colorais, null)
demolir: FormGroup(null, null, null, null, demoliNormally defective:demulais, null)
falir: FormGroup(null, null, null, null, fali, null)
florir: FormGroup(null, null, null, null, flori, null)
remir: FormGroup(null, null, null, null, remiNormally defective:redimais, null)
------GROUP: DefectiveGroup(false, false, true, false, false, false)
aprazer: FormGroup(null, null, apraza, null, null, null)
prazer: FormGroup(null, null, praza, null, null, null)
------GROUP: DefectiveGroup(false, true, true, true, true, true)
aturdir: FormGroup(null, aturde, aturda, aturdamos, aturdi, aturdam)
banir: FormGroup(null, bane, bana, banamos, bani, banam)
bramir: FormGroup(null, brame, brama, bramamos, brami, bramam)
brandir: FormGroup(null, brande, branda, brandamos, brandi, brandam)
carpir: FormGroup(null, carpe, carpa, carpamos, carpi, carpam)
combalir: FormGroup(null, combale, combala, combalamos, combali, combalam)
embair: FormGroup(null, embai, embaia, embaiamos, embaí, embaiam)
empedernir: FormGroup(null, empederne, empederna, empedernamos, empederni, empedernam)
esculpir: FormGroup(null, esculpe, esculpa, esculpamos, esculpi, esculpam)
espavorir: FormGroup(null, espavore, espavora, espavoramos, espavori, espavoram)
exaurir: FormGroup(null, exaure, exaura, exauramos, exauri, exauram)
feder: FormGroup(null, fede, feda, fedamos, fedei, fedam)
garrir: FormGroup(null, garre, garra, garramos, garri, garram)
impingir: FormGroup(null, impinge, impinja, impinjamos, impingi, impinjam)
jungir: FormGroup(null, junge, junja, junjamos, jungi, junjam)
manutenir: FormGroup(null, manutene, manutena, manutenamos, manuteni, manutenam)
premir: FormGroup(null, preme, prema, premamos, premi, premam)
renhir: FormGroup(null, renhe, renha, renhamos, renhi, renham)
ressarcir: FormGroup(null, ressarce, ressarça, ressarçamos, ressarci, ressarçam)
retorquir: FormGroup(null, retorque, retorqua, retorquamos, retorqui, retorquam)
soer: FormGroup(null, sói, soa, soamos, soei, soam)
transir: FormGroup(null, transe, transa, transamos, transi, transam)
------GROUP: DefectiveGroup(false, true, false, false, true, false)
barrir: FormGroup(null, barreNormally defective:barras, null, null, barriNormally defective:barrais, null)
delir: FormGroup(null, dele, null, null, deli, null)
explodir: FormGroup(null, explodeNormally defective:explodas, null, null, explodiNormally defective:explodais, null)
ganir: FormGroup(null, ganeNormally defective:ganas, null, null, ganiNormally defective:ganais, null)
ruir: FormGroup(null, ruiNormally defective:ruas, null, null, ruíNormally defective:ruais, null)
------GROUP: DefectiveGroup(false, false, true, false, false, true)
doer: FormGroup(null, null, doa, null, null, doam)